F  75,75,75

NO ./resources/red.xpm
SO ./resources/white.xpm
EA ./resources/wood.xpm
WE ./resources/wall_0.xpm

S ./resources/sprite_1.xpm

      11111111
      10000001
      10000001
1111111000000111111111111
1000000000000000000000001
1000000000001000000010001
1000000000001000000210001
10000000000N1111111112221
1000111111111111111111111
10001
11111