C 220,220,220
F 160,118,76

NO ./resources/white.xpm
SO ./resources/wall_0.xpm
EA ./resources/wall_1.xpm
WE ./resources/wood.xpm

S ./resources/sprite_1.xpm

11111111111
12000100001
10000100021
10000100001
11110001111
10000000021
10001011111
10001010021
12001010001
11111010001
1E000010001
11110000111
   100001
   120001
   111111